"filename", "language", "JavaScript", "JSON", "HTML", "CSS", "comment", "blank", "total"
"d:\Work\WebSigncryption\api\app.js", "JavaScript", 35, 0, 0, 0, 5, 10, 50
"d:\Work\WebSigncryption\api\package-lock.json", "JSON", 0, 995, 0, 0, 0, 1, 996
"d:\Work\WebSigncryption\api\package.json", "JSON", 0, 19, 0, 0, 0, 1, 20
"d:\Work\WebSigncryption\api\public\stylesheets\style.css", "CSS", 0, 0, 0, 7, 0, 2, 9
"d:\Work\WebSigncryption\api\routes\deSigCryp.js", "JavaScript", 16, 0, 0, 0, 14, 4, 34
"d:\Work\WebSigncryption\api\routes\enSigCryp.js", "JavaScript", 14, 0, 0, 0, 11, 4, 29
"d:\Work\WebSigncryption\api\routes\generateKey.js", "JavaScript", 7, 0, 0, 0, 1, 3, 11
"d:\Work\WebSigncryption\api\routes\index.js", "JavaScript", 6, 0, 0, 0, 1, 3, 10
"d:\Work\WebSigncryption\api\routes\users.js", "JavaScript", 6, 0, 0, 0, 1, 3, 10
"d:\Work\WebSigncryption\api\sigcrypt\deSig.js", "JavaScript", 27, 0, 0, 0, 0, 1, 28
"d:\Work\WebSigncryption\api\sigcrypt\enSig.js", "JavaScript", 34, 0, 0, 0, 4, 4, 42
"d:\Work\WebSigncryption\api\sigcrypt\getKey.js", "JavaScript", 13, 0, 0, 0, 1, 0, 14
"d:\Work\WebSigncryption\api\sigcrypt\init.js", "JavaScript", 8, 0, 0, 0, 0, 1, 9
"d:\Work\WebSigncryption\api\sigcrypt\test.js", "JavaScript", 41, 0, 0, 0, 12, 5, 58
"d:\Work\WebSigncryption\api\sigcrypt\tools.js", "JavaScript", 116, 0, 0, 0, 94, 24, 234
"d:\Work\WebSigncryption\api\views\error.ejs", "HTML", 0, 0, 3, 0, 0, 1, 4
"d:\Work\WebSigncryption\api\views\index.ejs", "HTML", 0, 0, 11, 0, 0, 1, 12
"Total", "-", 323, 1014, 14, 7, 144, 68, 1570